------------------------
-                      -
-                      -
-     B           @    -
-    -----  - - -      -
-    -----  - - - --   -
-    --           -    -
-    --           -  ---
-                      -
- S      T             -
------------------------
-                      -
-                      -
-                      -
-                      -
------------------------