------------------------
-                      -
-                      -
-                      -
-@        -----        -
-         -            -
----              #    -
-         --      ------
-         -            -
-     --  -            -
-     --     --        -
-     --     --        -
-     --     --        -
-     --     #         -
-     --           B TS-
------------------------