------------------------
-                  -   -
-                  ? @ -
-K                     -
---               ------
-                    K -
-       ---  -----------
-         ?  -         -
-            -       K -
-        -----       ---
-        #   ?         -
-                      -
--------------         -
-            ?         -
- S T B   K            -
------------------------