------------------------
-    -  -  -   -       -
-    -  -@ ?   -       -
-K   -  -      -       -
---     -----  -  K    -
- -     -  ?   -  --   -
-       -      -       -
- ----  -  -----       -
-       -      -       -
-       -TS    -      --
--      ---    -       -
-                      -
-          B           -
-          #           -
-                      -
------------------------