------------------------
-    -        -        -
-    -        -        -
-K   -        -        -
---           -        -
-        --   -        -
-         ?   ?#     @ -
-                      -
-  ---------------------
-  ?                   -
-                      -
------               K -
-          -- --     ---
- S T  B               -
----------********---**-
------------------------