------------------------
-  --K -         - KKK -
-  --K -         - -----
-  ??K -         - ??  -
-      -  K      -     -
- ------  --     ----- -
-                      -
-                      -
-           --        --
----                   -
-K ?                   -
-         --           -
-  ---           -------
-  ?             ????@ -
-K        S TB         -
----***-----------------